0   
1   
2   
3   
4   
5   
6   
7   
8   
9   35 36 40 
10   37 40 41 45 70 
11   38 39 42 45 46 50 71 75 
12   39 43 47 51 55 72 76 80 105 
13   44 48 52 56 60 73 77 81 85 106 110 
14   49 53 57 61 74 78 82 86 90 107 111 115 140 
15   
16   
17   
18   
19   
20   
21   
22   
23   
24   
25   
26   
27   
28   
29   35 36 
30   37 38 40 41 70 
31   38 39 42 43 45 46 50 71 75 
32   44 47 48 51 52 55 72 73 76 77 80 105 106 
33   48 49 52 53 56 60 74 77 78 81 82 85 106 107 110 111 140 
34   54 57 58 61 62 65 79 83 86 87 90 108 112 115 116 141 145 
35   58 59 62 63 66 67 84 88 91 92 95 96 100 109 113 117 120 121 125 142 146 150 175 
36   
37   
38   
39   
40   
41   
42   
43   
44   
45   
46   
47   
48   
49   35 
50   36 37 38 39 40 41 
51   42 43 44 45 46 47 50 70 71 72 73 75 
52   44 48 49 51 52 55 73 74 76 77 78 80 81 105 106 
53   53 54 56 57 60 61 79 82 83 85 86 107 108 109 110 111 112 115 140 
54   58 59 61 62 63 65 66 83 84 87 88 90 91 95 109 112 113 116 117 120 141 142 145 
55   59 63 64 67 84 88 89 92 93 96 100 109 113 114 117 118 121 122 125 142 143 146 147 150 175 176 
56   64 68 89 93 97 101 114 118 119 122 126 130 143 144 147 148 151 155 176 177 180 
57   69 94 98 123 127 152 156 181 185 210 
58   
59   
60   
61   
62   
63   
64   
65   
66   
67   
68   
69   
70   35 36 37 38 39 40 41 42 
71   43 44 45 46 47 48 49 50 70 71 72 73 74 75 76 
72   49 51 52 53 54 55 56 57 76 77 78 79 80 81 82 83 105 106 107 108 109 110 
73   57 58 59 60 61 62 82 83 84 85 86 87 88 90 108 109 111 112 113 115 116 140 141 
74   59 62 63 64 65 66 67 84 88 89 91 92 93 95 96 113 114 116 117 118 120 121 141 142 143 145 146 150 175 
75   64 67 68 69 89 93 94 96 97 100 101 118 119 121 122 123 125 126 143 144 147 148 150 151 155 175 176 177 180 
76   69 94 98 101 102 119 123 124 127 130 131 135 144 148 149 152 155 156 160 177 178 181 185 210 
77   99 102 103 124 128 131 132 135 136 149 153 157 160 161 165 178 182 186 190 211 215 
78   
79   
80   
81   
82   
83   
84   
85   
86   
87   
88   
89   
90   35 36 37 38 39 40 41 42 43 44 
91   43 44 45 46 47 48 49 50 51 52 70 71 72 73 74 75 76 77 78 79 
92   52 53 54 55 56 57 58 59 78 79 80 81 82 83 84 85 86 87 105 106 107 108 109 110 111 112 113 
93   58 59 60 61 62 63 64 65 66 84 86 87 88 89 90 91 92 111 112 113 114 115 116 117 118 120 140 141 142 143 144 145 146 
94   64 67 68 69 89 92 93 94 95 96 97 118 119 120 121 122 123 125 144 145 146 147 148 149 150 151 175 176 
95   69 94 98 99 100 101 102 123 124 126 127 128 130 149 151 152 153 155 156 177 178 179 180 181 185 210 
96   99 102 103 104 124 128 129 131 132 135 136 153 154 156 157 158 160 161 178 179 182 183 185 186 190 210 211 212 215 
97   103 104 129 132 133 136 137 154 157 158 161 162 165 166 170 179 183 186 187 190 191 195 212 215 216 220 245 
98   104 129 133 137 154 158 159 162 166 170 179 183 184 187 188 191 192 195 212 213 216 217 220 221 245 246 250 
99   
100   
101   
102   
103   
104   
105   
106   
107   
108   
109   
110   35 36 37 38 39 40 41 42 43 44 
111   45 46 47 48 49 50 51 52 53 54 56 57 58 59 70 71 72 73 74 75 76 77 78 79 80 81 82 83 84 106 107 108 109 
112   55 56 57 58 59 60 61 62 63 64 69 80 81 82 83 84 85 86 87 88 89 105 106 107 108 110 111 112 113 114 115 116 140 141 142 
113   64 65 66 67 68 69 90 91 92 93 94 95 96 97 98 99 115 116 117 118 119 120 121 122 123 124 140 141 143 144 145 146 147 148 149 150 175 176 
114   69 98 99 100 101 102 103 104 123 124 125 126 127 128 129 150 151 152 153 154 155 156 175 176 177 178 179 180 181 210 
115   103 104 128 129 130 131 132 133 134 135 154 156 157 158 159 160 161 182 183 184 185 186 187 190 210 211 212 215 
116   104 129 133 134 136 137 138 158 159 161 162 163 165 166 183 184 186 187 188 190 191 192 195 212 213 214 215 216 217 220 245 
117   134 137 138 159 162 163 166 167 170 184 188 189 191 192 195 196 213 214 216 217 218 220 221 245 246 250 
118   134 138 163 164 167 171 189 192 193 196 200 214 217 218 221 222 225 246 247 250 
119   0 139 164 168 172 189 193 197 201 205 218 222 226 230 247 251 255 
120   
121   
122   
123   
124   
125   
126   
127   
128   
129   
130   35 36 37 38 39 40 41 42 43 44 45 46 47 48 49 
131   45 46 47 48 49 50 51 52 53 54 55 56 57 58 59 60 61 62 63 64 69 70 71 72 73 74 75 76 77 78 79 80 81 82 83 84 87 88 89 105 106 107 108 109 
132   63 64 65 66 67 68 69 85 86 90 91 92 93 94 95 96 97 98 99 104 110 111 112 113 114 115 116 117 118 119 120 121 122 123 124 140 141 142 143 144 145 146 147 148 149 
133   95 96 98 99 100 101 102 103 104 121 125 126 127 128 129 130 131 134 145 148 149 150 151 152 153 154 158 175 176 177 178 179 180 181 183 184 
134   103 104 129 130 131 132 133 134 135 136 138 139 155 156 157 158 159 160 161 162 163 164 180 181 182 183 184 185 186 187 188 189 210 211 212 213 214 215 
135   133 134 135 136 137 138 139 159 161 162 163 164 165 166 167 168 187 188 189 190 191 192 193 195 213 214 215 216 217 218 219 220 221 245 246 247 
136   138 139 163 164 166 167 168 170 171 189 191 192 193 194 195 196 197 217 218 219 220 221 222 245 246 247 248 250 
137   0 139 164 167 168 169 170 171 172 193 194 196 197 200 218 219 222 223 225 226 247 248 250 251 255 
138   0 1 5 139 168 169 172 173 194 197 198 201 202 205 219 223 226 227 230 231 248 251 252 255 256 
139   1 5 169 173 194 198 202 206 219 223 227 231 235 248 252 256 260 
140   
141   
142   
143   
144   
145   
146   
147   
148   
149   
150   35 36 37 38 39 40 41 42 43 44 45 46 47 48 49 50 51 52 53 54 57 58 59 64 69 
151   55 56 59 60 61 62 63 64 65 66 67 68 69 70 71 72 73 74 75 76 77 78 79 80 81 82 83 84 85 86 87 88 89 90 91 92 93 94 95 96 97 98 99 100 101 102 103 104 105 106 107 108 109 110 111 112 113 114 115 116 117 118 119 121 122 123 124 
152   95 96 100 101 102 103 104 120 121 122 123 124 125 126 127 128 129 130 131 132 133 134 135 136 137 138 139 140 141 142 143 144 145 146 147 148 149 150 151 152 153 154 155 156 157 158 159 175 176 177 178 179 183 184 
153   130 131 132 133 134 135 136 137 138 139 155 156 157 158 159 160 161 162 163 164 165 166 167 168 169 175 180 181 182 183 184 185 186 187 188 189 192 193 194 210 211 212 213 214 215 216 
154   137 138 139 163 164 165 166 167 168 169 171 172 173 174 190 191 192 193 194 195 196 197 198 199 210 215 216 217 218 219 220 221 222 223 224 245 246 247 248 249 
155   166 167 168 169 170 171 172 173 174 193 194 195 196 197 198 199 200 201 220 221 222 223 224 225 226 227 245 246 247 248 249 250 251 252 253 254 
156   0 1 169 170 171 172 173 174 196 197 198 199 200 201 202 203 222 223 224 225 226 227 228 230 248 249 251 252 253 254 255 256 
157   0 1 2 5 173 174 198 199 201 202 203 205 206 224 227 228 230 231 235 249 252 253 254 255 256 257 260 
158   1 2 5 6 173 174 199 202 203 206 207 224 227 228 231 232 235 249 253 254 256 257 260 261 280 
159   2 6 10 174 199 203 207 224 228 232 236 240 249 253 257 261 265 280 
160   
161   
162   
163   
164   
165   
166   
167   
168   
169   
170   35 36 37 38 39 40 41 42 43 44 45 46 47 48 49 50 51 52 53 54 55 56 57 58 59 60 61 62 63 64 65 66 67 68 69 70 71 72 73 74 75 76 77 78 79 80 81 82 83 84 85 87 88 89 93 94 98 99 103 104 
171   86 90 91 92 95 96 97 100 101 102 105 106 107 108 109 110 111 112 113 114 115 116 117 118 119 120 121 122 123 124 125 126 127 128 129 130 131 132 133 134 135 136 137 138 139 140 141 142 143 144 145 146 147 148 149 150 151 152 153 154 155 156 157 158 159 160 161 162 163 164 165 166 167 168 169 170 171 172 173 174 177 178 179 182 183 184 187 188 189 192 193 
172   155 156 157 158 160 161 162 163 164 165 166 167 168 169 170 171 172 173 174 175 176 177 178 179 180 181 182 183 184 185 186 187 188 189 190 191 192 193 194 195 196 197 198 199 200 201 202 203 204 205 206 207 208 209 210 211 212 213 214 215 216 217 218 219 220 223 224 246 
173   170 171 172 173 174 190 191 195 196 197 198 199 200 201 202 203 204 205 206 207 208 209 210 215 216 217 218 219 220 221 222 223 224 225 226 227 228 229 230 231 232 233 234 245 246 247 248 249 250 251 252 253 254 258 259 
174   0 1 2 3 4 170 171 172 173 195 196 197 198 199 200 201 202 203 204 205 206 207 208 209 220 221 222 223 225 226 227 228 229 230 231 232 233 234 246 247 250 251 252 253 254 255 256 257 258 259 
175   0 1 2 3 4 5 6 7 8 9 200 201 202 203 204 205 206 207 208 209 227 228 229 230 231 232 233 234 235 236 253 254 255 256 257 258 259 260 261 262 
176   2 3 4 5 6 7 8 203 204 205 206 207 208 209 229 230 231 232 233 234 235 236 256 257 258 259 260 261 262 280 
177   3 4 6 7 8 10 11 204 206 207 208 209 229 232 233 234 235 236 237 257 258 259 260 261 262 265 266 280 281 
178   3 4 7 8 10 11 15 204 208 229 233 234 236 237 240 241 258 259 262 265 266 280 281 285 
179   3 4 7 8 11 15 204 208 229 233 234 237 240 241 254 258 259 262 266 270 281 282 285 
180   
181   
182   
183   
184   
185   
186   
187   
188   
189   
190   
191   0 1 2 3 4 5 6 7 8 9 10 11 12 13 14 17 18 19 175 176 180 181 185 186 190 191 194 195 196 197 198 199 200 201 202 203 204 205 206 207 208 209 210 211 212 213 214 215 216 217 218 219 220 221 222 223 224 225 226 227 228 229 230 231 232 233 234 235 236 237 238 239 240 241 242 243 244 245 246 247 248 249 250 251 252 253 254 255 256 257 258 259 260 261 262 263 264 265 266 267 268 269 270 271 272 273 274 275 276 277 278 279 
192   0 1 2 3 4 5 6 7 8 9 10 11 12 13 14 17 18 19 210 215 220 221 222 225 226 227 228 229 230 231 232 233 234 235 236 237 238 239 240 241 242 243 244 245 246 247 248 249 250 251 252 253 254 255 256 257 258 259 260 261 262 263 264 265 266 267 268 269 270 271 272 273 274 275 276 277 278 279 
193   0 1 2 3 4 5 6 7 8 9 10 11 12 13 14 17 18 19 230 231 232 233 234 235 236 237 238 239 240 241 242 243 244 250 251 252 253 255 256 257 258 259 260 261 262 263 264 265 266 267 268 269 270 271 272 273 274 277 278 279 280 281 282 283 284 
194   5 6 7 8 9 10 11 12 13 14 17 18 19 235 236 237 238 239 240 241 242 243 244 260 261 262 263 264 265 266 267 268 269 270 271 272 273 274 280 281 282 283 284 288 289 
195   5 6 8 9 10 11 12 13 14 15 16 17 235 236 237 238 239 240 241 242 243 244 260 261 262 263 264 265 266 267 268 269 280 281 282 283 284 285 286 287 288 289 
196   9 10 11 12 13 14 15 16 17 237 238 239 240 241 242 243 244 263 264 265 266 267 268 269 270 271 281 282 283 284 285 286 287 288 
197   9 12 13 14 15 16 17 20 238 239 240 241 242 243 263 264 266 267 268 270 271 282 283 284 285 286 287 290 315 
198   9 12 13 16 17 20 209 238 239 241 242 263 264 267 268 270 271 275 282 283 284 286 287 290 315 316 
199   8 9 12 13 16 17 20 209 234 238 239 242 259 263 264 267 268 271 275 282 283 286 287 290 291 315 316 320 
200   
201   
202   
203   
204   
205   
206   
207   
208   
209   
210   
211   15 16 20 21 22 23 24 25 26 27 28 29 30 31 32 33 34 280 281 282 283 284 285 286 287 288 289 290 291 292 293 294 295 296 297 298 299 300 301 302 303 304 305 306 307 308 309 310 311 312 313 314 315 316 317 318 319 320 321 322 323 324 325 326 327 328 329 330 331 332 333 334 335 336 337 338 339 340 341 342 343 344 345 346 347 348 349 350 351 352 353 354 355 356 357 358 359 360 361 362 363 364 365 367 368 369 373 374 378 379 383 384 
212   15 16 20 21 22 23 24 25 26 27 28 29 30 31 32 33 34 280 281 282 283 284 285 286 287 288 289 290 291 292 293 294 295 296 297 298 299 300 301 302 303 304 305 306 307 308 309 310 311 312 313 314 315 316 317 318 319 320 321 322 323 324 325 326 327 328 329 330 331 332 333 334 337 338 339 344 349 
213   15 16 20 21 22 23 24 25 26 27 28 29 30 31 32 33 34 275 276 277 278 279 280 281 282 285 286 287 288 289 290 291 292 293 294 295 296 297 298 299 300 301 302 303 304 306 307 308 309 315 316 317 318 319 320 321 322 323 324 325 326 327 328 329 
214   15 16 20 21 22 23 24 25 26 27 28 29 270 271 275 276 277 278 279 285 286 287 288 289 290 291 292 293 294 295 296 297 298 299 315 316 317 318 319 320 321 322 323 324 
215   18 19 20 21 22 23 24 25 26 28 29 270 271 272 273 274 275 276 277 278 279 290 291 292 293 294 295 296 297 298 299 315 316 317 318 319 320 321 322 323 324 
216   18 19 20 21 22 23 24 25 271 272 273 274 275 276 277 278 288 289 290 291 292 293 294 295 296 315 316 317 318 319 320 321 322 
217   14 18 19 20 21 22 25 244 269 272 273 274 275 276 277 288 289 291 292 293 295 296 316 317 318 319 320 321 
218   14 18 21 22 25 243 244 269 272 273 275 276 277 284 288 289 291 292 295 296 317 318 320 321 350 
219   14 18 21 22 25 26 239 243 244 268 269 272 273 276 277 284 288 291 292 295 296 300 317 320 321 325 350 
220   
221   
222   
223   
224   
225   
226   
227   
228   
229   
230   455 456 460 461 465 466 470 471 472 474 475 476 477 478 479 480 481 482 483 484 485 486 487 488 489 490 491 492 493 494 495 496 497 498 499 500 501 502 503 504 505 506 507 508 509 510 511 512 513 514 515 516 517 518 519 520 521 522 523 524 
231   366 370 371 372 375 376 377 380 381 382 385 386 387 388 389 390 391 392 393 394 395 396 397 398 399 400 401 402 403 404 405 406 407 408 409 410 411 412 413 414 415 416 417 418 419 420 421 422 423 424 425 426 427 428 429 430 431 432 433 434 435 436 437 438 439 440 441 442 443 444 445 446 447 448 449 450 451 452 453 454 457 458 459 462 463 464 467 468 469 473 
232   313 335 336 339 340 341 342 343 344 345 346 347 348 349 350 351 352 353 354 355 356 357 358 359 360 361 362 363 364 365 366 367 368 369 370 371 372 373 374 375 376 377 378 379 380 381 382 383 384 385 386 387 388 389 390 391 392 393 394 395 396 397 398 399 401 402 403 404 
233   300 301 305 306 307 308 309 310 311 312 313 314 325 326 327 328 329 330 331 332 333 334 335 336 337 338 339 340 341 342 343 344 349 350 351 352 353 354 355 356 357 358 359 360 361 362 363 364 367 368 369 385 386 387 388 389 
234   30 31 32 33 34 300 301 302 303 304 305 306 307 308 309 312 313 325 326 327 328 329 330 331 332 333 334 336 337 338 339 350 351 352 353 354 355 356 357 358 359 360 361 362 363 364 386 387 388 389 
235   25 26 27 28 29 30 31 32 33 34 297 298 299 300 301 302 303 304 305 306 323 324 325 326 327 328 329 330 331 332 350 351 352 353 354 355 356 357 358 359 
236   26 27 28 29 30 31 32 279 297 298 299 300 301 302 303 323 324 325 326 327 328 329 330 350 351 352 353 354 355 356 
237   23 24 26 27 28 30 31 278 279 293 294 297 298 299 300 301 302 322 323 324 325 326 327 330 350 351 352 353 355 
238   19 23 24 26 27 30 31 274 278 279 293 294 297 300 301 318 319 322 323 325 326 330 351 355 
239   19 23 26 27 30 31 274 277 278 289 293 297 300 301 305 318 319 322 325 326 330 351 355 
240   
241   
242   
243   
244   
245   
246   
247   
248   
249   
250   490 495 500 501 502 505 506 507 508 509 510 511 512 513 514 515 516 517 518 519 520 521 522 523 524 
251   435 436 437 438 440 441 442 443 444 445 446 447 448 449 450 451 452 453 454 455 456 457 458 459 460 461 462 463 464 465 466 467 468 469 470 471 472 473 474 475 476 477 478 479 480 481 482 483 484 485 486 487 488 489 490 491 492 493 494 495 496 497 498 499 500 503 504 
252   375 376 380 381 382 383 384 400 401 402 403 404 405 406 407 408 409 410 411 412 413 414 415 416 417 418 419 420 421 422 423 424 425 426 427 428 429 430 431 432 433 434 435 436 437 438 439 455 456 457 458 459 463 464 
253   343 344 345 346 347 348 349 365 366 370 371 372 373 374 375 376 377 378 379 384 390 391 392 393 394 395 396 397 398 399 400 401 402 403 404 420 421 422 423 424 425 426 427 428 429 
254   310 311 312 313 314 335 336 337 338 339 340 341 342 343 344 349 360 361 362 363 364 365 366 367 368 369 385 386 387 388 390 391 392 393 394 395 396 420 421 422 
255   305 306 307 308 309 310 311 312 313 314 332 333 334 335 336 337 338 339 358 359 360 361 362 363 364 365 366 367 385 386 387 388 389 390 391 392 393 
256   33 34 303 304 305 306 307 308 310 311 329 331 332 333 334 335 336 337 356 357 358 359 360 361 362 363 385 386 387 388 389 390 
257   29 32 33 34 299 302 303 304 305 306 307 310 324 328 329 331 332 335 353 354 356 357 358 360 361 385 386 
258   28 29 32 33 279 298 299 302 303 305 306 310 324 327 328 331 332 335 352 353 356 357 360 385 386 
259   24 28 32 279 294 298 302 306 310 319 323 327 331 335 352 356 360 385 
260   
261   
262   
263   
264   
265   
266   
267   
268   
269   
270   510 511 512 513 514 515 516 517 518 519 520 521 522 523 524 
271   450 451 452 453 454 470 471 472 475 476 477 478 479 480 481 482 483 484 485 486 487 488 489 490 495 496 497 498 499 500 501 502 503 504 505 506 507 508 509 510 511 512 513 514 
272   410 411 412 413 414 415 416 417 418 419 435 436 437 438 439 440 441 442 443 444 445 446 447 448 449 455 460 461 462 463 464 465 466 467 468 469 473 474 490 491 492 493 494 495 496 
273   375 376 378 379 380 381 382 383 384 401 405 406 407 408 409 410 411 414 425 428 429 430 431 432 433 434 438 455 456 457 458 459 460 461 463 464 
274   344 345 346 347 348 349 370 371 372 373 374 375 376 377 378 379 395 396 397 398 399 400 401 402 403 404 420 421 423 424 425 426 427 428 429 430 455 456 
275   312 313 314 338 339 340 341 342 343 344 345 346 364 366 367 368 369 370 371 372 391 392 393 394 395 396 397 398 400 420 421 422 423 424 425 426 
276   309 311 312 313 314 337 338 339 340 341 342 362 363 364 365 366 367 368 370 388 389 391 392 393 395 396 420 421 
277   34 304 308 309 311 312 333 334 336 337 340 341 359 362 363 365 366 387 388 389 390 391 392 395 420 
278   29 33 34 303 304 307 308 311 328 329 332 333 336 340 354 357 358 361 362 365 386 387 390 391 420 
279   29 33 299 303 307 311 324 328 332 336 340 353 357 361 365 386 390 
280   
281   
282   
283   
284   
285   
286   
287   
288   
289   
290   515 516 517 518 519 520 521 522 523 524 
291   450 451 452 453 475 476 477 478 479 480 481 482 483 484 485 486 487 488 489 500 501 502 503 505 506 507 508 509 510 511 512 513 514 
292   417 418 419 443 444 445 446 447 448 449 451 452 453 454 470 471 472 473 474 475 476 477 478 479 490 495 496 497 498 499 500 501 502 503 504 
293   383 384 409 410 411 412 413 414 415 416 418 419 435 436 437 438 439 440 441 442 443 444 460 461 462 463 464 465 466 467 468 469 490 491 492 493 494 495 
294   349 378 379 380 381 382 383 384 403 404 405 406 407 408 409 430 431 432 433 434 435 436 455 456 457 458 459 460 461 490 
295   344 347 348 349 369 372 373 374 375 376 377 398 399 400 401 402 403 405 424 425 426 427 428 429 430 431 455 456 
296   314 339 342 343 344 345 346 347 364 368 369 371 372 373 375 376 393 394 396 397 398 400 401 421 422 423 425 426 430 455 
297   309 313 314 338 339 341 342 343 345 346 363 364 367 368 370 371 375 389 392 393 396 397 400 421 422 425 
298   309 312 313 334 337 338 341 342 345 359 363 366 367 370 388 392 395 396 421 425 
299   34 304 308 312 329 333 337 341 354 358 362 366 370 387 391 395 420 
300   
301   
302   
303   
304   
305   
306   
307   
308   
309   
310   515 516 517 518 519 520 521 522 523 524 
311   480 481 482 483 484 485 486 487 488 489 507 508 509 510 511 512 513 514 515 516 
312   446 447 448 449 450 451 452 453 454 472 473 474 475 476 477 478 479 480 481 500 501 502 503 504 505 506 507 
313   413 414 415 416 417 418 419 439 441 442 443 444 445 446 447 448 467 468 469 470 471 472 473 475 493 494 495 496 497 498 499 500 501 
314   383 384 408 409 410 411 412 413 414 415 434 436 437 438 439 440 441 462 463 464 465 466 467 470 490 491 492 495 
315   349 374 378 379 380 381 382 403 404 406 407 408 410 429 431 432 433 435 436 457 458 459 460 461 465 490 
316   344 347 348 349 369 373 374 376 377 380 381 398 399 401 402 403 405 406 423 424 427 428 430 431 435 455 456 457 460 
317   314 339 343 344 347 364 368 369 372 373 376 380 389 393 394 397 398 401 402 405 422 423 426 427 430 455 456 
318   309 313 314 338 339 342 343 346 347 364 368 371 372 375 376 380 389 393 397 400 401 405 422 426 430 455 
319   
320   
321   
322   
323   
324   
325   
326   
327   
328   
329   
330   517 518 519 520 521 522 523 524 
331   483 484 485 486 487 488 489 509 510 511 512 513 514 515 516 
332   449 450 451 452 453 454 476 477 478 479 480 481 482 483 502 503 504 505 506 507 508 510 
333   418 419 443 444 446 447 448 450 451 469 471 472 473 474 475 476 477 497 498 499 500 501 502 
334   384 409 413 414 416 417 418 438 439 441 442 443 445 446 463 464 466 467 468 470 471 475 492 493 494 495 496 497 500 
335   379 382 383 384 404 408 409 411 412 415 416 433 434 436 437 438 440 441 458 459 462 463 465 466 470 490 491 492 495 
336   349 374 378 381 382 399 403 404 407 410 411 415 424 428 429 432 435 436 440 457 458 461 465 490 
337   344 348 369 373 377 381 394 398 399 402 406 410 423 424 427 428 431 435 456 457 460 
338   
339   
340   
341   
342   
343   
344   
345   
346   
347   
348   
349   524 
350   518 519 520 521 522 523 
351   484 486 487 488 489 509 512 513 514 515 516 517 
352   453 454 478 479 481 482 483 485 486 504 507 508 510 511 515 
353   419 444 447 448 449 450 451 452 473 474 476 477 480 498 499 502 503 505 506 
354   414 417 418 439 442 443 446 447 450 464 468 469 471 472 475 476 493 494 496 497 498 500 501 
355   383 384 409 412 413 416 417 434 437 438 441 442 445 446 450 459 463 466 467 470 471 475 492 495 496 500 
356   379 382 383 404 408 411 412 415 416 429 433 437 440 441 445 458 462 466 470 491 495 
357   349 374 378 403 407 432 436 461 465 490 
358   
359   
360   
361   
362   
363   
364   
365   
366   
367   
368   
369   523 524 
370   489 518 519 521 522 
371   484 488 509 513 514 516 517 520 521 
372   453 454 479 482 483 486 487 504 507 508 511 512 515 
373   419 448 449 452 453 474 477 478 481 482 485 499 503 506 507 510 511 
374   414 418 443 444 447 451 469 472 473 476 480 494 497 498 501 502 505 
375   384 409 413 417 434 438 439 442 446 450 459 463 464 467 468 471 475 492 493 496 497 500 501 
376   
377   
378   
379   
380   
381   
382   
383   
384   
385   
386   
387   
388   
389   519 523 524 
390   489 514 518 519 522 
391   484 488 509 513 514 517 520 521 
392   454 479 483 487 504 508 512 516 520 
393   449 453 474 478 482 486 499 503 507 511 515 
394   419 444 448 452 469 473 477 481 485 498 502 506 510 
395   
396   
397   
398   
